0100111000
0110100000
0000111110
0111100000
0100m01010
0101111011
0001010010
0111011010
0100010000
e001110110